6 10
0 0
- - M M - M - - ? +
- - - - - - - - + +
- - - - + - - - + +
- - - - + ? - - + +
M - - - - - - - M $
+ + - - - - - - - M